##########################################################
####################################### ##################
####################################### ##################
#######################################              #####
                              ######### ############ #####
############################# ######### ############ #####
########## ################## ######### ############ #####
########## ##################           ############     #
########## ################## ###################### #####
           ################## ###################### #####
########## ##################                   #### #####
########## ################## ################# #### #####
########## ################## ################# #### #####
########## ################## ################# #### #####
########## ################## ################# #### #####
########## ################## ################# #### #####
########## ##################                   #### #####
########## ################## ###################### #####
########## ################## ###################### #####
##########                    ###################### #####
############################# ##########             #####
############################# ############################
##########################################################